V<<<<<<<<<<<A<<<<s<<<<<<<<<<<<
VV<<<<<<<<<<AA<<<s<<<<a<<<<<<^
VV##^###^###VV#SS#####$#####^^
VV##^#$#^###VV#^^<<<<<<<<<<<BB
CC>dD>c>E>¡>VV#^^<<<<<<<<<<<B^
VV#$V#V#^#V#VV#^^###########^^
VV##V#V#^$y#VV#JJ>>>>>K>>>>>^^
VV<<F<j<G<H<II#^J>>>>KK>>ñ>>^^
VV#$V#$###V#VV#^^####VV##$##^^
LL>i>>k>>>M>VV#^n$###VV#####^^
VV##S##$##V#VV#^^####SS#####^^
VV<<<s<m<<<N<<<ÑÑ<<<<<<s<<<<OO
VV<<<s<<<<<NN<<Ñ<<<<<<<s<<<<O^
VV#########VV###^^##########^^
VV########$oV###^^##########^^
VV#########VV###^^###$######^^
VP>>Qs>>>>>>>R>>&&>>>p!>>>>s^^
PP>QQs>>>>>>RR>>>&>>>!!>>>>s^^
VV#VV#SS####VV#^^####VV#####SS
VV#VV#^q$###VV#^^###$rV#####^^
VV#VV#^^####VV#^^####VV#####^^
VV#VV#^^#$##VV#^^####VV#####^^
VV#VV#^^<t<<TT<UU<<<<WW<<<<<XX
VV#VV#^^<<<<TT<UU<u<<WW<<<<<X^
VV#VV#^^####VV#^^#$##VV#####^^
VV#VV#^w$###VV#^^####VV#####^^
VV#VV#^^####VV#^^####VV#####^^
VV#VV#^^####SS#^^####SS##$##^^
V>>>>>YY>>>s>>>ZZ>>>s>>>>x>>^^
>>>>>>>Y>>>s>>>>Z>>>s>>>>>>>>^